20 10
####################
#................<.#
#..................#
#..####............#
#..#..#............#
#.#...#............#
#..####............#
#..................#
#..................#
####################
@uh 3 5 Mam 17 5
