20 10
####################
#................<.#
#..................#
#...###............#
#.....#............#
#.....#............#
#...###............#
#..................#
#..................#
####################
@uh 17 5 Mcm 17 5
